wwwwwwFwwwww
wDDFFwFwFPFw
wDDFFwwwFFFw
wDDFFFFFCCFw
wDDFFwFwFCFw
wDDwwwFwFCFw
wwwwFCFwCFFw
FFFwFFCwFCFw
FFFwFCFFCFFw
FFFwFFwwFFFw
FFFwwwwwwwww




