wwwwwwwwwwww
wFPFFFFFFFFw
wFFFFFFFFFFw
wFFwwwFFFFFw
wFFwwwFFCFFw
wFFwwwFFFFFw
wFFwwwwwFFFw
wFFwwwwwFFFw
wFFwwwwwFFFw
wFFFFFFFDFFw
wFFFFFFFFFFw
wwwwwwwwwwww