wwwwwwwwww
wFFwwwwwFw
wwwFFFFwFw
wwDPCFFFww
wwwFFFFwww
wwDwwCFwww
wwFwFFFww
wwFFFFFFww
wwFFFFFFww
wwwwwwww